サッポロ	札幌	北海道札幌市
ハコダテ	函館	北海道函館市
オタル	小樽	北海道小樽市
アサヒカワ	旭川	北海道旭川市
ムロラン	室蘭	北海道室蘭市
クシロ	釧路	北海道釧路市
オビヒロ	帯広	北海道帯広市
キタミ	北見	北海道北見市
ユウバリ	夕張	北海道夕張市
イワミザワ	岩見沢	北海道岩見沢市
アバシリ	網走	北海道網走市
ルモイ	留萌	北海道留萌市
トマコマイ	苫小牧	北海道苫小牧市
ワッカナイ	稚内	北海道稚内市
ビバイ	美唄	北海道美唄市
アシベツ	芦別	北海道芦別市
エベツ	江別	北海道江別市
アカビラ	赤平	北海道赤平市
モンベツ	紋別	北海道紋別市
シベツ	士別	北海道士別市
ナヨロ	名寄	北海道名寄市
ミカサ	三笠	北海道三笠市
ネムロ	根室	北海道根室市
チトセ	千歳	北海道千歳市
タキカワ	滝川	北海道滝川市
スナガワ	砂川	北海道砂川市
ウタシナイ	歌志内	北海道歌志内市
フカガワ	深川	北海道深川市
フラノ	富良野	北海道富良野市
ノボリベツ	登別	北海道登別市
エニワ	恵庭	北海道恵庭市
ダテ	伊達	北海道伊達市
キタヒロシマ	北広島	北海道北広島市
イシカリ	石狩	北海道石狩市
ホクト	北斗	北海道北斗市
トウベツ	当別	北海道当別町
シンシノツ	新篠津	北海道新篠津村
マツマエ	松前	北海道松前町
フクシマ	福島	北海道福島町
シリウチ	知内	北海道知内町
キコナイ	木古内	北海道木古内町
ナナエ	七飯	北海道七飯町
シカベ	鹿部	北海道鹿部町
モリ	森	北海道森町
ヤクモ	八雲	北海道八雲町
オシャマンベ	長万部	北海道長万部町
エサシ	江差	北海道江差町
カミノクニ	上ノ国	北海道上ノ国町
アッサブ	厚沢部	北海道厚沢部町
オトベ	乙部	北海道乙部町
オクシリ	奥尻	北海道奥尻町
イマカネ	今金	北海道今金町
セタナ	せたな	北海道せたな町
シママキ	島牧	北海道島牧村
スッツ	寿都	北海道寿都町
クロマツナイ	黒松内	北海道黒松内町
ランコシ	蘭越	北海道蘭越町
ニセコ	ニセコ	北海道ニセコ町
マッカリ	真狩	北海道真狩村
ルスツ	留寿都	北海道留寿都村
キモベツ	喜茂別	北海道喜茂別町
キョウゴク	京極	北海道京極町
クッチャン	倶知安	北海道倶知安町
キョウワ	共和	北海道共和町
イワナイ	岩内	北海道岩内町
トマリ	泊	北海道泊村
カモエナイ	神恵内	北海道神恵内村
シャコタン	積丹	北海道積丹町
フルビラ	古平	北海道古平町
ニキ	仁木	北海道仁木町
ヨイチ	余市	北海道余市町
アカイガワ	赤井川	北海道赤井川村
ナンポロ	南幌	北海道南幌町
ナイエ	奈井江	北海道奈井江町
カミスナガワ	上砂川	北海道上砂川町
ユニ	由仁	北海道由仁町
ナガヌマ	長沼	北海道長沼町
クリヤマ	栗山	北海道栗山町
ツキガタ	月形	北海道月形町
ウラウス	浦臼	北海道浦臼町
シントツカワ	新十津川	北海道新十津川町
モセウシ	妹背牛	北海道妹背牛町
チップベツ	秩父別	北海道秩父別町
ウリュウ	雨竜	北海道雨竜町
ホクリュウ	北竜	北海道北竜町
ヌマタ	沼田	北海道沼田町
タカス	鷹栖	北海道鷹栖町
ヒガシカグラ	東神楽	北海道東神楽町
トウマ	当麻	北海道当麻町
ピップ	比布	北海道比布町
アイベツ	愛別	北海道愛別町
カミカワ	上川	北海道上川町
ヒガシカワ	東川	北海道東川町
ビエイ	美瑛	北海道美瑛町
カミフラノ	上富良野	北海道上富良野町
ナカフラノ	中富良野	北海道中富良野町
ミナミフラノ	南富良野	北海道南富良野町
シムカップ	占冠	北海道占冠村
ワッサム	和寒	北海道和寒町
ケンブチ	剣淵	北海道剣淵町
シモカワ	下川	北海道下川町
ビフカ	美深	北海道美深町
オトイネップ	音威子府	北海道音威子府村
ナカガワ	中川	北海道中川町
ホロカナイ	幌加内	北海道幌加内町
マシケ	増毛	北海道増毛町
オビラ	小平	北海道小平町
トママエ	苫前	北海道苫前町
ハボロ	羽幌	北海道羽幌町
ショサンベツ	初山別	北海道初山別村
エンベツ	遠別	北海道遠別町
テシオ	天塩	北海道天塩町
サルフツ	猿払	北海道猿払村
ハマトンベツ	浜頓別	北海道浜頓別町
ナカトンベツ	中頓別	北海道中頓別町
エサシ	枝幸	北海道枝幸町
トヨトミ	豊富	北海道豊富町
レブン	礼文	北海道礼文町
リシリ	利尻	北海道利尻町
リシリフジ	利尻富士	北海道利尻富士町
ホロノベ	幌延	北海道幌延町
ビホロ	美幌	北海道美幌町
ツベツ	津別	北海道津別町
シャリ	斜里	北海道斜里町
キヨサト	清里	北海道清里町
コシミズ	小清水	北海道小清水町
クンネップ	訓子府	北海道訓子府町
オケト	置戸	北海道置戸町
サロマ	佐呂間	北海道佐呂間町
エンガル	遠軽	北海道遠軽町
ユウベツ	湧別	北海道湧別町
タキノウエ	滝上	北海道滝上町
オコッペ	興部	北海道興部町
ニシオコッペ	西興部	北海道西興部村
オウム	雄武	北海道雄武町
オオゾラ	大空	北海道大空町
トヨウラ	豊浦	北海道豊浦町
ソウベツ	壮瞥	北海道壮瞥町
シラオイ	白老	北海道白老町
アツマ	厚真	北海道厚真町
トウヤコ	洞爺湖	北海道洞爺湖町
アビラ	安平	北海道安平町
ムカワ	むかわ	北海道むかわ町
ヒダカ	日高	北海道日高町
ビラトリ	平取	北海道平取町
ニイカップ	新冠	北海道新冠町
ウラカワ	浦河	北海道浦河町
サマニ	様似	北海道様似町
エリモ	えりも	北海道えりも町
シンヒダカ	新ひだか	北海道新ひだか町
オトフケ	音更	北海道音更町
シホロ	士幌	北海道士幌町
カミシホロ	上士幌	北海道上士幌町
シカオイ	鹿追	北海道鹿追町
シントク	新得	北海道新得町
シミズ	清水	北海道清水町
メムロ	芽室	北海道芽室町
ナカサツナイ	中札内	北海道中札内村
サラベツ	更別	北海道更別村
タイキ	大樹	北海道大樹町
ヒロオ	広尾	北海道広尾町
マクベツ	幕別	北海道幕別町
イケダ	池田	北海道池田町
トヨコロ	豊頃	北海道豊頃町
ホンベツ	本別	北海道本別町
アショロ	足寄	北海道足寄町
リクベツ	陸別	北海道陸別町
ウラホロ	浦幌	北海道浦幌町
クシロ	釧路	北海道釧路町
アッケシ	厚岸	北海道厚岸町
ハマナカ	浜中	北海道浜中町
シベチャ	標茶	北海道標茶町
テシカガ	弟子屈	北海道弟子屈町
ツルイ	鶴居	北海道鶴居村
シラヌカ	白糠	北海道白糠町
ベツカイ	別海	北海道別海町
ナカシベツ	中標津	北海道中標津町
シベツ	標津	北海道標津町
ラウス	羅臼	北海道羅臼町
アオモリ	青森	青森県青森市
ヒロサキ	弘前	青森県弘前市
ハチノヘ	八戸	青森県八戸市
クロイシ	黒石	青森県黒石市
ゴショガワラ	五所川原	青森県五所川原市
トワダ	十和田	青森県十和田市
ミサワ	三沢	青森県三沢市
ムツ	むつ	青森県むつ市
ツガル	つがる	青森県つがる市
ヒラカワ	平川	青森県平川市
ヒラナイ	平内	青森県平内町
イマベツ	今別	青森県今別町
ヨモギタ	蓬田	青森県蓬田村
ソトガハマ	外ヶ浜	青森県外ヶ浜町
アジガサワ	鰺ヶ沢	青森県鰺ヶ沢町
フカウラ	深浦	青森県深浦町
ニシメヤ	西目屋	青森県西目屋村
フジサキ	藤崎	青森県藤崎町
オオワニ	大鰐	青森県大鰐町
イナカダテ	田舎館	青森県田舎館村
イタヤナギ	板柳	青森県板柳町
ツルタ	鶴田	青森県鶴田町
ナカドマリ	中泊	青森県中泊町
ノヘジ	野辺地	青森県野辺地町
シチノヘ	七戸	青森県七戸町
ロクノヘ	六戸	青森県六戸町
ヨコハマ	横浜	青森県横浜町
トウホク	東北	青森県東北町
ロッカショ	六ヶ所	青森県六ヶ所村
オイラセ	おいらせ	青森県おいらせ町
オオマ	大間	青森県大間町
ヒガシドオリ	東通	青森県東通村
カザマウラ	風間浦	青森県風間浦村
サイ	佐井	青森県佐井村
サンノヘ	三戸	青森県三戸町
ゴノヘ	五戸	青森県五戸町
タッコ	田子	青森県田子町
ナンブ	南部	青森県南部町
ハシカミ	階上	青森県階上町
シンゴウ	新郷	青森県新郷村
モリオカ	盛岡	岩手県盛岡市
ミヤコ	宮古	岩手県宮古市
オオフナト	大船渡	岩手県大船渡市
ハナマキ	花巻	岩手県花巻市
キタカミ	北上	岩手県北上市
クジ	久慈	岩手県久慈市
トオノ	遠野	岩手県遠野市
イチノセキ	一関	岩手県一関市
リクゼンタカタ	陸前高田	岩手県陸前高田市
カマイシ	釜石	岩手県釜石市
ニノヘ	二戸	岩手県二戸市
ハチマンタイ	八幡平	岩手県八幡平市
オウシュウ	奥州	岩手県奥州市
タキザワ	滝沢	岩手県滝沢市
シズクイシ	雫石	岩手県雫石町
クズマキ	葛巻	岩手県葛巻町
イワテ	岩手	岩手県岩手町
シワ	紫波	岩手県紫波町
ヤハバ	矢巾	岩手県矢巾町
ニシワガ	西和賀	岩手県西和賀町
カネガサキ	金ケ崎	岩手県金ケ崎町
ヒライズミ	平泉	岩手県平泉町
スミタ	住田	岩手県住田町
オオツチ	大槌	岩手県大槌町
ヤマダ	山田	岩手県山田町
イワイズミ	岩泉	岩手県岩泉町
タノハタ	田野畑	岩手県田野畑村
フダイ	普代	岩手県普代村
カルマイ	軽米	岩手県軽米町
ノダ	野田	岩手県野田村
クノヘ	九戸	岩手県九戸村
ヒロノ	洋野	岩手県洋野町
イチノヘ	一戸	岩手県一戸町
センダイ	仙台	宮城県仙台市
イシノマキ	石巻	宮城県石巻市
シオガマ	塩竈	宮城県塩竈市
ケセンヌマ	気仙沼	宮城県気仙沼市
シロイシ	白石	宮城県白石市
ナトリ	名取	宮城県名取市
カクダ	角田	宮城県角田市
タガジョウ	多賀城	宮城県多賀城市
イワヌマ	岩沼	宮城県岩沼市
トメ	登米	宮城県登米市
クリハラ	栗原	宮城県栗原市
ヒガシマツシマ	東松島	宮城県東松島市
オオサキ	大崎	宮城県大崎市
トミヤ	富谷	宮城県富谷市
ザオウ	蔵王	宮城県蔵王町
シチカシュク	七ヶ宿	宮城県七ヶ宿町
オオガワラ	大河原	宮城県大河原町
ムラタ	村田	宮城県村田町
シバタ	柴田	宮城県柴田町
カワサキ	川崎	宮城県川崎町
マルモリ	丸森	宮城県丸森町
ワタリ	亘理	宮城県亘理町
ヤマモト	山元	宮城県山元町
マツシマ	松島	宮城県松島町
シチガハマ	七ヶ浜	宮城県七ヶ浜町
リフ	利府	宮城県利府町
タイワ	大和	宮城県大和町
オオサト	大郷	宮城県大郷町
オオヒラ	大衡	宮城県大衡村
シカマ	色麻	宮城県色麻町
カミ	加美	宮城県加美町
ワクヤ	涌谷	宮城県涌谷町
ミサト	美里	宮城県美里町
オナガワ	女川	宮城県女川町
ミナミサンリク	南三陸	宮城県南三陸町
アキタ	秋田	秋田県秋田市
ノシロ	能代	秋田県能代市
ヨコテ	横手	秋田県横手市
オオダテ	大館	秋田県大館市
オガ	男鹿	秋田県男鹿市
ユザワ	湯沢	秋田県湯沢市
カヅノ	鹿角	秋田県鹿角市
ユリホンジョウ	由利本荘	秋田県由利本荘市
カタガミ	潟上	秋田県潟上市
ダイセン	大仙	秋田県大仙市
キタアキタ	北秋田	秋田県北秋田市
ニカホ	にかほ	秋田県にかほ市
センボク	仙北	秋田県仙北市
コサカ	小坂	秋田県小坂町
カミコアニ	上小阿仁	秋田県上小阿仁村
フジサト	藤里	秋田県藤里町
ミタネ	三種	秋田県三種町
ハッポウ	八峰	秋田県八峰町
ゴジョウメ	五城目	秋田県五城目町
ハチロウガタ	八郎潟	秋田県八郎潟町
イカワ	井川	秋田県井川町
オオガタ	大潟	秋田県大潟村
ミサト	美郷	秋田県美郷町
ウゴ	羽後	秋田県羽後町
ヒガシナルセ	東成瀬	秋田県東成瀬村
ヤマガタ	山形	山形県山形市
ヨネザワ	米沢	山形県米沢市
ツルオカ	鶴岡	山形県鶴岡市
サカタ	酒田	山形県酒田市
シンジョウ	新庄	山形県新庄市
サガエ	寒河江	山形県寒河江市
カミノヤマ	上山	山形県上山市
ムラヤマ	村山	山形県村山市
ナガイ	長井	山形県長井市
テンドウ	天童	山形県天童市
ヒガシネ	東根	山形県東根市
オバナザワ	尾花沢	山形県尾花沢市
ナンヨウ	南陽	山形県南陽市
ヤマノベ	山辺	山形県山辺町
ナカヤマ	中山	山形県中山町
カホク	河北	山形県河北町
ニシカワ	西川	山形県西川町
アサヒ	朝日	山形県朝日町
オオエ	大江	山形県大江町
オオイシダ	大石田	山形県大石田町
カネヤマ	金山	山形県金山町
モガミ	最上	山形県最上町
フナガタ	舟形	山形県舟形町
マムロガワ	真室川	山形県真室川町
オオクラ	大蔵	山形県大蔵村
サケガワ	鮭川	山形県鮭川村
トザワ	戸沢	山形県戸沢村
タカハタ	高畠	山形県高畠町
カワニシ	川西	山形県川西町
オグニ	小国	山形県小国町
シラタカ	白鷹	山形県白鷹町
イイデ	飯豊	山形県飯豊町
ミカワ	三川	山形県三川町
シヨウナイ	庄内	山形県庄内町
ユザ	遊佐	山形県遊佐町
フクシマ	福島	福島県福島市
アイヅワカマツ	会津若松	福島県会津若松市
コオリヤマ	郡山	福島県郡山市
イワキ	いわき	福島県いわき市
シラカワ	白河	福島県白河市
スカガワ	須賀川	福島県須賀川市
キタカタ	喜多方	福島県喜多方市
ソウマ	相馬	福島県相馬市
ニホンマツ	二本松	福島県二本松市
タムラ	田村	福島県田村市
ミナミソウマ	南相馬	福島県南相馬市
ダテ	伊達	福島県伊達市
モトミヤ	本宮	福島県本宮市
コオリ	桑折	福島県桑折町
クニミ	国見	福島県国見町
カワマタ	川俣	福島県川俣町
オオタマ	大玉	福島県大玉村
カガミイシ	鏡石	福島県鏡石町
テンエイ	天栄	福島県天栄村
シモゴウ	下郷	福島県下郷町
ヒノエマタ	檜枝岐	福島県檜枝岐村
タダミ	只見	福島県只見町
ミナミアイヅ	南会津	福島県南会津町
キタシオバラ	北塩原	福島県北塩原村
ニシアイヅ	西会津	福島県西会津町
バンダイ	磐梯	福島県磐梯町
イナワシロ	猪苗代	福島県猪苗代町
アイヅバンゲ	会津坂下	福島県会津坂下町
ユガワ	湯川	福島県湯川村
ヤナイヅ	柳津	福島県柳津町
ミシマ	三島	福島県三島町
カネヤマ	金山	福島県金山町
ショウワ	昭和	福島県昭和村
アイヅミサト	会津美里	福島県会津美里町
ニシゴウ	西郷	福島県西郷村
イズミザキ	泉崎	福島県泉崎村
ナカジマ	中島	福島県中島村
ヤブキ	矢吹	福島県矢吹町
タナグラ	棚倉	福島県棚倉町
ヤマツリ	矢祭	福島県矢祭町
ハナワ	塙	福島県塙町
サメガワ	鮫川	福島県鮫川村
イシカワ	石川	福島県石川町
タマカワ	玉川	福島県玉川村
ヒラタ	平田	福島県平田村
アサカワ	浅川	福島県浅川町
フルドノ	古殿	福島県古殿町
ミハル	三春	福島県三春町
オノ	小野	福島県小野町
ヒロノ	広野	福島県広野町
ナラハ	楢葉	福島県楢葉町
トミオカ	富岡	福島県富岡町
カワウチ	川内	福島県川内村
オオクマ	大熊	福島県大熊町
フタバ	双葉	福島県双葉町
ナミエ	浪江	福島県浪江町
カツラオ	葛尾	福島県葛尾村
シンチ	新地	福島県新地町
イイタテ	飯舘	福島県飯舘村
ミト	水戸	茨城県水戸市
ヒタチ	日立	茨城県日立市
ツチウラ	土浦	茨城県土浦市
コガ	古河	茨城県古河市
イシオカ	石岡	茨城県石岡市
ユウキ	結城	茨城県結城市
リュウガサキ	龍ケ崎	茨城県龍ケ崎市
シモツマ	下妻	茨城県下妻市
ジョウソウ	常総	茨城県常総市
ヒタチオオタ	常陸太田	茨城県常陸太田市
タカハギ	高萩	茨城県高萩市
キタイバラキ	北茨城	茨城県北茨城市
カサマ	笠間	茨城県笠間市
トリデ	取手	茨城県取手市
ウシク	牛久	茨城県牛久市
ツクバ	つくば	茨城県つくば市
ヒタチナカ	ひたちなか	茨城県ひたちなか市
カシマ	鹿嶋	茨城県鹿嶋市
イタコ	潮来	茨城県潮来市
モリヤ	守谷	茨城県守谷市
ヒタチオオミヤ	常陸大宮	茨城県常陸大宮市
ナカ	那珂	茨城県那珂市
チクセイ	筑西	茨城県筑西市
バンドウ	坂東	茨城県坂東市
イナシキ	稲敷	茨城県稲敷市
カスミガウラ	かすみがうら	茨城県かすみがうら市
サクラガワ	桜川	茨城県桜川市
カミス	神栖	茨城県神栖市
ナメガタ	行方	茨城県行方市
ホコタ	鉾田	茨城県鉾田市
ツクバミライ	つくばみらい	茨城県つくばみらい市
オミタマ	小美玉	茨城県小美玉市
イバラキ	茨城	茨城県茨城町
オオアライ	大洗	茨城県大洗町
シロサト	城里	茨城県城里町
トウカイ	東海	茨城県東海村
ダイゴ	大子	茨城県大子町
ミホ	美浦	茨城県美浦村
アミ	阿見	茨城県阿見町
カワチ	河内	茨城県河内町
ヤチヨ	八千代	茨城県八千代町
ゴカ	五霞	茨城県五霞町
サカイ	境	茨城県境町
トネ	利根	茨城県利根町
ウツノミヤ	宇都宮	栃木県宇都宮市
アシカガ	足利	栃木県足利市
トチギ	栃木	栃木県栃木市
サノ	佐野	栃木県佐野市
カヌマ	鹿沼	栃木県鹿沼市
ニッコウ	日光	栃木県日光市
オヤマ	小山	栃木県小山市
モオカ	真岡	栃木県真岡市
オオタワラ	大田原	栃木県大田原市
ヤイタ	矢板	栃木県矢板市
ナスシオバラ	那須塩原	栃木県那須塩原市
サクラ	さくら	栃木県さくら市
ナスカラスヤマ	那須烏山	栃木県那須烏山市
シモツケ	下野	栃木県下野市
カミノカワ	上三川	栃木県上三川町
マシコ	益子	栃木県益子町
モテギ	茂木	栃木県茂木町
イチカイ	市貝	栃木県市貝町
ハガ	芳賀	栃木県芳賀町
ミブ	壬生	栃木県壬生町
ノギ	野木	栃木県野木町
シオヤ	塩谷	栃木県塩谷町
タカネザワ	高根沢	栃木県高根沢町
ナス	那須	栃木県那須町
ナカガワ	那珂川	栃木県那珂川町
マエバシ	前橋	群馬県前橋市
タカサキ	高崎	群馬県高崎市
キリュウ	桐生	群馬県桐生市
イセサキ	伊勢崎	群馬県伊勢崎市
オオタ	太田	群馬県太田市
ヌマタ	沼田	群馬県沼田市
タテバヤシ	館林	群馬県館林市
シブカワ	渋川	群馬県渋川市
フジオカ	藤岡	群馬県藤岡市
トミオカ	富岡	群馬県富岡市
アンナカ	安中	群馬県安中市
ミドリ	みどり	群馬県みどり市
シントウ	榛東	群馬県榛東村
ヨシオカ	吉岡	群馬県吉岡町
ウエノ	上野	群馬県上野村
カンナ	神流	群馬県神流町
シモニタ	下仁田	群馬県下仁田町
ナンモク	南牧	群馬県南牧村
カンラ	甘楽	群馬県甘楽町
ナカノジヨウ	中之条	群馬県中之条町
ナガノハラ	長野原	群馬県長野原町
ツマゴイ	嬬恋	群馬県嬬恋村
クサツ	草津	群馬県草津町
タカヤマ	高山	群馬県高山村
ヒガシアガツマ	東吾妻	群馬県東吾妻町
カタシナ	片品	群馬県片品村
カワバ	川場	群馬県川場村
ショウワ	昭和	群馬県昭和村
ミナカミ	みなかみ	群馬県みなかみ町
タマムラ	玉村	群馬県玉村町
イタクラ	板倉	群馬県板倉町
メイワ	明和	群馬県明和町
チヨダ	千代田	群馬県千代田町
オオイズミ	大泉	群馬県大泉町
オウラ	邑楽	群馬県邑楽町
サイタマ	さいたま	埼玉県さいたま市
カワゴエ	川越	埼玉県川越市
クマガヤ	熊谷	埼玉県熊谷市
カワグチ	川口	埼玉県川口市
ギヨウダ	行田	埼玉県行田市
チチブ	秩父	埼玉県秩父市
トコロザワ	所沢	埼玉県所沢市
ハンノウ	飯能	埼玉県飯能市
カゾ	加須	埼玉県加須市
ホンジヨウ	本庄	埼玉県本庄市
ヒガシマツヤマ	東松山	埼玉県東松山市
カスカベ	春日部	埼玉県春日部市
サヤマ	狭山	埼玉県狭山市
ハニユウ	羽生	埼玉県羽生市
コウノス	鴻巣	埼玉県鴻巣市
フカヤ	深谷	埼玉県深谷市
アゲオ	上尾	埼玉県上尾市
ソウカ	草加	埼玉県草加市
コシガヤ	越谷	埼玉県越谷市
ワラビ	蕨	埼玉県蕨市
トダ	戸田	埼玉県戸田市
イルマ	入間	埼玉県入間市
アサカ	朝霞	埼玉県朝霞市
シキ	志木	埼玉県志木市
ワコウ	和光	埼玉県和光市
ニイザ	新座	埼玉県新座市
オケガワ	桶川	埼玉県桶川市
クキ	久喜	埼玉県久喜市
キタモト	北本	埼玉県北本市
ヤシオ	八潮	埼玉県八潮市
フジミ	富士見	埼玉県富士見市
ミサト	三郷	埼玉県三郷市
ハスダ	蓮田	埼玉県蓮田市
サカド	坂戸	埼玉県坂戸市
サッテ	幸手	埼玉県幸手市
ツルガシマ	鶴ヶ島	埼玉県鶴ヶ島市
ヒダカ	日高	埼玉県日高市
ヨシカワ	吉川	埼玉県吉川市
フジミノ	ふじみ野	埼玉県ふじみ野市
シラオカ	白岡	埼玉県白岡市
イナ	伊奈	埼玉県伊奈町
ミヨシ	三芳	埼玉県三芳町
モロヤマ	毛呂山	埼玉県毛呂山町
オゴセ	越生	埼玉県越生町
ナメガワ	滑川	埼玉県滑川町
ランザン	嵐山	埼玉県嵐山町
オガワ	小川	埼玉県小川町
カワジマ	川島	埼玉県川島町
ヨシミ	吉見	埼玉県吉見町
ハトヤマ	鳩山	埼玉県鳩山町
トキガワ	ときがわ	埼玉県ときがわ町
ヨコゼ	横瀬	埼玉県横瀬町
ミナノ	皆野	埼玉県皆野町
ナガトロ	長瀞	埼玉県長瀞町
オガノ	小鹿野	埼玉県小鹿野町
ヒガシチチブ	東秩父	埼玉県東秩父村
ミサト	美里	埼玉県美里町
カミカワ	神川	埼玉県神川町
カミサト	上里	埼玉県上里町
ヨリイ	寄居	埼玉県寄居町
ミヤシロ	宮代	埼玉県宮代町
スギト	杉戸	埼玉県杉戸町
マツブシ	松伏	埼玉県松伏町
チバ	千葉	千葉県千葉市
チョウシ	銚子	千葉県銚子市
イチカワ	市川	千葉県市川市
フナバシ	船橋	千葉県船橋市
タテヤマ	館山	千葉県館山市
キサラヅ	木更津	千葉県木更津市
マツド	松戸	千葉県松戸市
ノダ	野田	千葉県野田市
モバラ	茂原	千葉県茂原市
ナリタ	成田	千葉県成田市
サクラ	佐倉	千葉県佐倉市
トウガネ	東金	千葉県東金市
アサヒ	旭	千葉県旭市
ナラシノ	習志野	千葉県習志野市
カシワ	柏	千葉県柏市
カツウラ	勝浦	千葉県勝浦市
イチハラ	市原	千葉県市原市
ナガレヤマ	流山	千葉県流山市
ヤチヨ	八千代	千葉県八千代市
アビコ	我孫子	千葉県我孫子市
カモガワ	鴨川	千葉県鴨川市
カマガヤ	鎌ケ谷	千葉県鎌ケ谷市
キミツ	君津	千葉県君津市
フッツ	富津	千葉県富津市
ウラヤス	浦安	千葉県浦安市
ヨツカイドウ	四街道	千葉県四街道市
ソデガウラ	袖ケ浦	千葉県袖ケ浦市
ヤチマタ	八街	千葉県八街市
インザイ	印西	千葉県印西市
シロイ	白井	千葉県白井市
トミサト	富里	千葉県富里市
ミナミボウソウ	南房総	千葉県南房総市
ソウサ	匝瑳	千葉県匝瑳市
カトリ	香取	千葉県香取市
サンム	山武	千葉県山武市
イスミ	いすみ	千葉県いすみ市
オオアミシラサト	大網白里	千葉県大網白里市
シスイ	酒々井	千葉県酒々井町
サカエ	栄	千葉県栄町
コウザキ	神崎	千葉県神崎町
タコ	多古	千葉県多古町
トウノショウ	東庄	千葉県東庄町
クジユウクリ	九十九里	千葉県九十九里町
シバヤマ	芝山	千葉県芝山町
ヨコシバヒカリ	横芝光	千葉県横芝光町
イチノミヤ	一宮	千葉県一宮町
ムツザワ	睦沢	千葉県睦沢町
チョウセイ	長生	千葉県長生村
シラコ	白子	千葉県白子町
ナガラ	長柄	千葉県長柄町
チョウナン	長南	千葉県長南町
オオタキ	大多喜	千葉県大多喜町
オンジユク	御宿	千葉県御宿町
キヨナン	鋸南	千葉県鋸南町
チヨダ	千代田	東京都千代田区
チュウオウ	中央	東京都中央区
ミナト	港	東京都港区
シンジュク	新宿	東京都新宿区
ブンキョウ	文京	東京都文京区
タイトウ	台東	東京都台東区
スミダ	墨田	東京都墨田区
コウトウ	江東	東京都江東区
シナガワ	品川	東京都品川区
メグロ	目黒	東京都目黒区
オオタ	大田	東京都大田区
セタガヤ	世田谷	東京都世田谷区
シブヤ	渋谷	東京都渋谷区
ナカノ	中野	東京都中野区
スギナミ	杉並	東京都杉並区
トシマ	豊島	東京都豊島区
キタ	北	東京都北区
アラカワ	荒川	東京都荒川区
イタバシ	板橋	東京都板橋区
ネリマ	練馬	東京都練馬区
アダチ	足立	東京都足立区
カツシカ	葛飾	東京都葛飾区
エドガワ	江戸川	東京都江戸川区
ハチオウジ	八王子	東京都八王子市
タチカワ	立川	東京都立川市
ムサシノ	武蔵野	東京都武蔵野市
ミタカ	三鷹	東京都三鷹市
オウメ	青梅	東京都青梅市
フチュウ	府中	東京都府中市
アキシマ	昭島	東京都昭島市
チョウフ	調布	東京都調布市
マチダ	町田	東京都町田市
コガネイ	小金井	東京都小金井市
コダイラ	小平	東京都小平市
ヒノ	日野	東京都日野市
ヒガシムラヤマ	東村山	東京都東村山市
コクブンジ	国分寺	東京都国分寺市
クニタチ	国立	東京都国立市
フッサ	福生	東京都福生市
コマエ	狛江	東京都狛江市
ヒガシヤマト	東大和	東京都東大和市
キヨセ	清瀬	東京都清瀬市
ヒガシクルメ	東久留米	東京都東久留米市
ムサシムラヤマ	武蔵村山	東京都武蔵村山市
タマ	多摩	東京都多摩市
イナギ	稲城	東京都稲城市
ハムラ	羽村	東京都羽村市
アキルノ	あきる野	東京都あきる野市
ニシトウキョウ	西東京	東京都西東京市
ミズホ	瑞穂	東京都瑞穂町
ヒノデ	日の出	東京都日の出町
ヒノハラ	檜原	東京都檜原村
オクタマ	奥多摩	東京都奥多摩町
オオシマ	大島	東京都大島町
トシマ	利島	東京都利島村
ニイジマ	新島	東京都新島村
コウヅシマ	神津島	東京都神津島村
ミヤケ	三宅	東京都三宅村
ミクラジマ	御蔵島	東京都御蔵島村
ハチジョウ	八丈	東京都八丈町
アオガシマ	青ヶ島	東京都青ヶ島村
オガサワラ	小笠原	東京都小笠原村
ヨコハマ	横浜	神奈川県横浜市
カワサキ	川崎	神奈川県川崎市
サガミハラ	相模原	神奈川県相模原市
ヨコスカ	横須賀	神奈川県横須賀市
ヒラツカ	平塚	神奈川県平塚市
カマクラ	鎌倉	神奈川県鎌倉市
フジサワ	藤沢	神奈川県藤沢市
オダワラ	小田原	神奈川県小田原市
チガサキ	茅ヶ崎	神奈川県茅ヶ崎市
ズシ	逗子	神奈川県逗子市
ミウラ	三浦	神奈川県三浦市
ハダノ	秦野	神奈川県秦野市
アツギ	厚木	神奈川県厚木市
ヤマト	大和	神奈川県大和市
イセハラ	伊勢原	神奈川県伊勢原市
エビナ	海老名	神奈川県海老名市
ザマ	座間	神奈川県座間市
ミナミアシガラ	南足柄	神奈川県南足柄市
アヤセ	綾瀬	神奈川県綾瀬市
ハヤマ	葉山	神奈川県葉山町
サムカワ	寒川	神奈川県寒川町
オオイソ	大磯	神奈川県大磯町
ニノミヤ	二宮	神奈川県二宮町
ナカイ	中井	神奈川県中井町
オオイ	大井	神奈川県大井町
マツダ	松田	神奈川県松田町
ヤマキタ	山北	神奈川県山北町
カイセイ	開成	神奈川県開成町
ハコネ	箱根	神奈川県箱根町
マナツル	真鶴	神奈川県真鶴町
ユガワラ	湯河原	神奈川県湯河原町
アイカワ	愛川	神奈川県愛川町
キヨカワ	清川	神奈川県清川村
ニイガタ	新潟	新潟県新潟市
ナガオカ	長岡	新潟県長岡市
サンジョウ	三条	新潟県三条市
カシワザキ	柏崎	新潟県柏崎市
シバタ	新発田	新潟県新発田市
オヂヤ	小千谷	新潟県小千谷市
カモ	加茂	新潟県加茂市
トオカマチ	十日町	新潟県十日町市
ミツケ	見附	新潟県見附市
ムラカミ	村上	新潟県村上市
ツバメ	燕	新潟県燕市
イトイガワ	糸魚川	新潟県糸魚川市
ミョウコウ	妙高	新潟県妙高市
ゴセン	五泉	新潟県五泉市
ジョウエツ	上越	新潟県上越市
アガノ	阿賀野	新潟県阿賀野市
サド	佐渡	新潟県佐渡市
ウオヌマ	魚沼	新潟県魚沼市
ミナミウオヌマ	南魚沼	新潟県南魚沼市
タイナイ	胎内	新潟県胎内市
セイロウ	聖籠	新潟県聖籠町
ヤヒコ	弥彦	新潟県弥彦村
タガミ	田上	新潟県田上町
アガ	阿賀	新潟県阿賀町
イズモザキ	出雲崎	新潟県出雲崎町
ユザワ	湯沢	新潟県湯沢町
ツナン	津南	新潟県津南町
カリワ	刈羽	新潟県刈羽村
セキカワ	関川	新潟県関川村
アワシマウラ	粟島浦	新潟県粟島浦村
トヤマ	富山	富山県富山市
タカオカ	高岡	富山県高岡市
ウオヅ	魚津	富山県魚津市
ヒミ	氷見	富山県氷見市
ナメリカワ	滑川	富山県滑川市
クロベ	黒部	富山県黒部市
トナミ	砺波	富山県砺波市
オヤベ	小矢部	富山県小矢部市
ナント	南砺	富山県南砺市
イミズ	射水	富山県射水市
フナハシ	舟橋	富山県舟橋村
カミイチ	上市	富山県上市町
タテヤマ	立山	富山県立山町
ニュウゼン	入善	富山県入善町
アサヒ	朝日	富山県朝日町
カナザワ	金沢	石川県金沢市
ナナオ	七尾	石川県七尾市
コマツ	小松	石川県小松市
ワジマ	輪島	石川県輪島市
スズ	珠洲	石川県珠洲市
カガ	加賀	石川県加賀市
ハクイ	羽咋	石川県羽咋市
カホク	かほく	石川県かほく市
ハクサン	白山	石川県白山市
ノミ	能美	石川県能美市
ノノイチ	野々市	石川県野々市市
カワキタ	川北	石川県川北町
ツバタ	津幡	石川県津幡町
ウチナダ	内灘	石川県内灘町
シカ	志賀	石川県志賀町
ホウダツシミズ	宝達志水	石川県宝達志水町
ナカノト	中能登	石川県中能登町
アナミズ	穴水	石川県穴水町
ノト	能登	石川県能登町
フクイ	福井	福井県福井市
ツルガ	敦賀	福井県敦賀市
オバマ	小浜	福井県小浜市
オオノ	大野	福井県大野市
カツヤマ	勝山	福井県勝山市
サバエ	鯖江	福井県鯖江市
アワラ	あわら	福井県あわら市
エチゼン	越前	福井県越前市
サカイ	坂井	福井県坂井市
エイヘイジ	永平寺	福井県永平寺町
イケダ	池田	福井県池田町
ミナミエチゼン	南越前	福井県南越前町
エチゼン	越前	福井県越前町
ミハマ	美浜	福井県美浜町
タカハマ	高浜	福井県高浜町
オオイ	おおい	福井県おおい町
ワカサ	若狭	福井県若狭町
コウフ	甲府	山梨県甲府市
フジヨシダ	富士吉田	山梨県富士吉田市
ツル	都留	山梨県都留市
ヤマナシ	山梨	山梨県山梨市
オオツキ	大月	山梨県大月市
ニラサキ	韮崎	山梨県韮崎市
ミナミアルプス	南アルプス	山梨県南アルプス市
ホクト	北杜	山梨県北杜市
カイ	甲斐	山梨県甲斐市
フエフキ	笛吹	山梨県笛吹市
ウエノハラ	上野原	山梨県上野原市
コウシュウ	甲州	山梨県甲州市
チュウオウ	中央	山梨県中央市
イチカワミサト	市川三郷	山梨県市川三郷町
ハヤカワ	早川	山梨県早川町
ミノブ	身延	山梨県身延町
ナンブ	南部	山梨県南部町
フジカワ	富士川	山梨県富士川町
ショウワ	昭和	山梨県昭和町
ドウシ	道志	山梨県道志村
ニシカツラ	西桂	山梨県西桂町
オシノ	忍野	山梨県忍野村
ヤマナカコ	山中湖	山梨県山中湖村
ナルサワ	鳴沢	山梨県鳴沢村
フジカワグチコ	富士河口湖	山梨県富士河口湖町
コスゲ	小菅	山梨県小菅村
タバヤマ	丹波山	山梨県丹波山村
ナガノ	長野	長野県長野市
マツモト	松本	長野県松本市
ウエダ	上田	長野県上田市
オカヤ	岡谷	長野県岡谷市
イイダ	飯田	長野県飯田市
スワ	諏訪	長野県諏訪市
スザカ	須坂	長野県須坂市
コモロ	小諸	長野県小諸市
イナ	伊那	長野県伊那市
コマガネ	駒ヶ根	長野県駒ヶ根市
ナカノ	中野	長野県中野市
オオマチ	大町	長野県大町市
イイヤマ	飯山	長野県飯山市
チノ	茅野	長野県茅野市
シオジリ	塩尻	長野県塩尻市
サク	佐久	長野県佐久市
チクマ	千曲	長野県千曲市
トウミ	東御	長野県東御市
アヅミノ	安曇野	長野県安曇野市
コウミ	小海	長野県小海町
カワカミ	川上	長野県川上村
ミナミマキ	南牧	長野県南牧村
ミナミアイキ	南相木	長野県南相木村
キタアイキ	北相木	長野県北相木村
サクホ	佐久穂	長野県佐久穂町
カルイザワ	軽井沢	長野県軽井沢町
ミヨタ	御代田	長野県御代田町
タテシナ	立科	長野県立科町
アオキ	青木	長野県青木村
ナガワ	長和	長野県長和町
シモスワ	下諏訪	長野県下諏訪町
フジミ	富士見	長野県富士見町
ハラ	原	長野県原村
タツノ	辰野	長野県辰野町
ミノワ	箕輪	長野県箕輪町
イイジマ	飯島	長野県飯島町
ミナミミノワ	南箕輪	長野県南箕輪村
ナカガワ	中川	長野県中川村
ミヤダ	宮田	長野県宮田村
マツカワ	松川	長野県松川町
タカモリ	高森	長野県高森町
アナン	阿南	長野県阿南町
アチ	阿智	長野県阿智村
ヒラヤ	平谷	長野県平谷村
ネバ	根羽	長野県根羽村
シモジョウ	下條	長野県下條村
ウルギ	売木	長野県売木村
テンリュウ	天龍	長野県天龍村
ヤスオカ	泰阜	長野県泰阜村
タカギ	喬木	長野県喬木村
トヨオカ	豊丘	長野県豊丘村
オオシカ	大鹿	長野県大鹿村
アゲマツ	上松	長野県上松町
ナギソ	南木曽	長野県南木曽町
キソ	木祖	長野県木祖村
オウタキ	王滝	長野県王滝村
オオクワ	大桑	長野県大桑村
キソ	木曽	長野県木曽町
オミ	麻績	長野県麻績村
イクサカ	生坂	長野県生坂村
ヤマガタ	山形	長野県山形村
アサヒ	朝日	長野県朝日村
チクホク	筑北	長野県筑北村
イケダ	池田	長野県池田町
マツカワ	松川	長野県松川村
ハクバ	白馬	長野県白馬村
オタリ	小谷	長野県小谷村
サカキ	坂城	長野県坂城町
オブセ	小布施	長野県小布施町
タカヤマ	高山	長野県高山村
ヤマノウチ	山ノ内	長野県山ノ内町
キジマダイラ	木島平	長野県木島平村
ノザワオンセン	野沢温泉	長野県野沢温泉村
シナノ	信濃	長野県信濃町
オガワ	小川	長野県小川村
イイヅナ	飯綱	長野県飯綱町
サカエ	栄	長野県栄村
ギフ	岐阜	岐阜県岐阜市
オオガキ	大垣	岐阜県大垣市
タカヤマ	高山	岐阜県高山市
タジミ	多治見	岐阜県多治見市
セキ	関	岐阜県関市
ナカツガワ	中津川	岐阜県中津川市
ミノ	美濃	岐阜県美濃市
ミズナミ	瑞浪	岐阜県瑞浪市
ハシマ	羽島	岐阜県羽島市
エナ	恵那	岐阜県恵那市
ミノカモ	美濃加茂	岐阜県美濃加茂市
トキ	土岐	岐阜県土岐市
カカミガハラ	各務原	岐阜県各務原市
カニ	可児	岐阜県可児市
ヤマガタ	山県	岐阜県山県市
ミズホ	瑞穂	岐阜県瑞穂市
ヒダ	飛騨	岐阜県飛騨市
モトス	本巣	岐阜県本巣市
グジョウ	郡上	岐阜県郡上市
ゲロ	下呂	岐阜県下呂市
カイヅ	海津	岐阜県海津市
ギナン	岐南	岐阜県岐南町
カサマツ	笠松	岐阜県笠松町
ヨウロウ	養老	岐阜県養老町
タルイ	垂井	岐阜県垂井町
セキガハラ	関ケ原	岐阜県関ケ原町
ゴウド	神戸	岐阜県神戸町
ワノウチ	輪之内	岐阜県輪之内町
アンパチ	安八	岐阜県安八町
イビガワ	揖斐川	岐阜県揖斐川町
オオノ	大野	岐阜県大野町
イケダ	池田	岐阜県池田町
キタガタ	北方	岐阜県北方町
サカホギ	坂祝	岐阜県坂祝町
トミカ	富加	岐阜県富加町
カワベ	川辺	岐阜県川辺町
ヒチソウ	七宗	岐阜県七宗町
ヤオツ	八百津	岐阜県八百津町
シラカワ	白川	岐阜県白川町
ヒガシシラカワ	東白川	岐阜県東白川村
ミタケ	御嵩	岐阜県御嵩町
シラカワ	白川	岐阜県白川村
シズオカ	静岡	静岡県静岡市
ハママツ	浜松	静岡県浜松市
ヌマヅ	沼津	静岡県沼津市
アタミ	熱海	静岡県熱海市
ミシマ	三島	静岡県三島市
フジノミヤ	富士宮	静岡県富士宮市
イトウ	伊東	静岡県伊東市
シマダ	島田	静岡県島田市
フジ	富士	静岡県富士市
イワタ	磐田	静岡県磐田市
ヤイヅ	焼津	静岡県焼津市
カケガワ	掛川	静岡県掛川市
フジエダ	藤枝	静岡県藤枝市
ゴテンバ	御殿場	静岡県御殿場市
フクロイ	袋井	静岡県袋井市
シモダ	下田	静岡県下田市
スソノ	裾野	静岡県裾野市
コサイ	湖西	静岡県湖西市
イズ	伊豆	静岡県伊豆市
オマエザキ	御前崎	静岡県御前崎市
キクガワ	菊川	静岡県菊川市
イズノクニ	伊豆の国	静岡県伊豆の国市
マキノハラ	牧之原	静岡県牧之原市
ヒガシイズ	東伊豆	静岡県東伊豆町
カワヅ	河津	静岡県河津町
ミナミイズ	南伊豆	静岡県南伊豆町
マツザキ	松崎	静岡県松崎町
ニシイズ	西伊豆	静岡県西伊豆町
カンナミ	函南	静岡県函南町
シミズ	清水	静岡県清水町
ナガイズミ	長泉	静岡県長泉町
オヤマ	小山	静岡県小山町
ヨシダ	吉田	静岡県吉田町
カワネホン	川根本	静岡県川根本町
モリ	森	静岡県森町
ナゴヤ	名古屋	愛知県名古屋市
トヨハシ	豊橋	愛知県豊橋市
オカザキ	岡崎	愛知県岡崎市
イチノミヤ	一宮	愛知県一宮市
セト	瀬戸	愛知県瀬戸市
ハンダ	半田	愛知県半田市
カスガイ	春日井	愛知県春日井市
トヨカワ	豊川	愛知県豊川市
ツシマ	津島	愛知県津島市
ヘキナン	碧南	愛知県碧南市
カリヤ	刈谷	愛知県刈谷市
トヨタ	豊田	愛知県豊田市
アンジョウ	安城	愛知県安城市
ニシオ	西尾	愛知県西尾市
ガマゴオリ	蒲郡	愛知県蒲郡市
イヌヤマ	犬山	愛知県犬山市
トコナメ	常滑	愛知県常滑市
コウナン	江南	愛知県江南市
コマキ	小牧	愛知県小牧市
イナザワ	稲沢	愛知県稲沢市
シンシロ	新城	愛知県新城市
トウカイ	東海	愛知県東海市
オオブ	大府	愛知県大府市
チタ	知多	愛知県知多市
チリュウ	知立	愛知県知立市
オワリアサヒ	尾張旭	愛知県尾張旭市
タカハマ	高浜	愛知県高浜市
イワクラ	岩倉	愛知県岩倉市
トヨアケ	豊明	愛知県豊明市
ニッシン	日進	愛知県日進市
タハラ	田原	愛知県田原市
アイサイ	愛西	愛知県愛西市
キヨス	清須	愛知県清須市
キタナゴヤ	北名古屋	愛知県北名古屋市
ヤトミ	弥富	愛知県弥富市
ミヨシ	みよし	愛知県みよし市
アマ	あま	愛知県あま市
ナガクテ	長久手	愛知県長久手市
トウゴウ	東郷	愛知県東郷町
トヨヤマ	豊山	愛知県豊山町
オオグチ	大口	愛知県大口町
フソウ	扶桑	愛知県扶桑町
オオハル	大治	愛知県大治町
カニエ	蟹江	愛知県蟹江町
トビシマ	飛島	愛知県飛島村
アグイ	阿久比	愛知県阿久比町
ヒガシウラ	東浦	愛知県東浦町
ミナミチタ	南知多	愛知県南知多町
ミハマ	美浜	愛知県美浜町
タケトヨ	武豊	愛知県武豊町
コウタ	幸田	愛知県幸田町
シタラ	設楽	愛知県設楽町
トウエイ	東栄	愛知県東栄町
トヨネ	豊根	愛知県豊根村
ツ	津	三重県津市
ヨッカイチ	四日市	三重県四日市市
イセ	伊勢	三重県伊勢市
マツサカ	松阪	三重県松阪市
クワナ	桑名	三重県桑名市
スズカ	鈴鹿	三重県鈴鹿市
ナバリ	名張	三重県名張市
オワセ	尾鷲	三重県尾鷲市
カメヤマ	亀山	三重県亀山市
トバ	鳥羽	三重県鳥羽市
クマノ	熊野	三重県熊野市
イナベ	いなべ	三重県いなべ市
シマ	志摩	三重県志摩市
イガ	伊賀	三重県伊賀市
キソサキ	木曽岬	三重県木曽岬町
トウイン	東員	三重県東員町
コモノ	菰野	三重県菰野町
アサヒ	朝日	三重県朝日町
カワゴエ	川越	三重県川越町
タキ	多気	三重県多気町
メイワ	明和	三重県明和町
オオダイ	大台	三重県大台町
タマキ	玉城	三重県玉城町
ワタライ	度会	三重県度会町
タイキ	大紀	三重県大紀町
ミナミイセ	南伊勢	三重県南伊勢町
キホク	紀北	三重県紀北町
ミハマ	御浜	三重県御浜町
キホウ	紀宝	三重県紀宝町
オオツ	大津	滋賀県大津市
ヒコネ	彦根	滋賀県彦根市
ナガハマ	長浜	滋賀県長浜市
オウミハチマン	近江八幡	滋賀県近江八幡市
クサツ	草津	滋賀県草津市
モリヤマ	守山	滋賀県守山市
リットウ	栗東	滋賀県栗東市
コウカ	甲賀	滋賀県甲賀市
ヤス	野洲	滋賀県野洲市
コナン	湖南	滋賀県湖南市
タカシマ	高島	滋賀県高島市
ヒガシオウミ	東近江	滋賀県東近江市
マイバラ	米原	滋賀県米原市
ヒノ	日野	滋賀県日野町
リユウオウ	竜王	滋賀県竜王町
アイショウ	愛荘	滋賀県愛荘町
トヨサト	豊郷	滋賀県豊郷町
コウラ	甲良	滋賀県甲良町
タガ	多賀	滋賀県多賀町
キョウト	京都	京都府京都市
フクチヤマ	福知山	京都府福知山市
マイヅル	舞鶴	京都府舞鶴市
アヤベ	綾部	京都府綾部市
ウジ	宇治	京都府宇治市
ミヤヅ	宮津	京都府宮津市
カメオカ	亀岡	京都府亀岡市
ジョウヨウ	城陽	京都府城陽市
ムコウ	向日	京都府向日市
ナガオカキョウ	長岡京	京都府長岡京市
ヤワタ	八幡	京都府八幡市
キョウタナベ	京田辺	京都府京田辺市
キョウタンゴ	京丹後	京都府京丹後市
ナンタン	南丹	京都府南丹市
キヅガワ	木津川	京都府木津川市
オオヤマザキ	大山崎	京都府大山崎町
クミヤマ	久御山	京都府久御山町
イデ	井手	京都府井手町
ウジタワラ	宇治田原	京都府宇治田原町
カサギ	笠置	京都府笠置町
ワヅカ	和束	京都府和束町
セイカ	精華	京都府精華町
ミナミヤマシロ	南山城	京都府南山城村
キョウタンバ	京丹波	京都府京丹波町
イネ	伊根	京都府伊根町
ヨサノ	与謝野	京都府与謝野町
オオサカ	大阪	大阪府大阪市
サカイ	堺	大阪府堺市
キシワダ	岸和田	大阪府岸和田市
トヨナカ	豊中	大阪府豊中市
イケダ	池田	大阪府池田市
スイタ	吹田	大阪府吹田市
イズミオオツ	泉大津	大阪府泉大津市
タカツキ	高槻	大阪府高槻市
カイヅカ	貝塚	大阪府貝塚市
モリグチ	守口	大阪府守口市
ヒラカタ	枚方	大阪府枚方市
イバラキ	茨木	大阪府茨木市
ヤオ	八尾	大阪府八尾市
イズミサノ	泉佐野	大阪府泉佐野市
トンダバヤシ	富田林	大阪府富田林市
ネヤガワ	寝屋川	大阪府寝屋川市
カワチナガノ	河内長野	大阪府河内長野市
マツバラ	松原	大阪府松原市
ダイトウ	大東	大阪府大東市
イズミ	和泉	大阪府和泉市
ミノオ	箕面	大阪府箕面市
カシワラ	柏原	大阪府柏原市
ハビキノ	羽曳野	大阪府羽曳野市
カドマ	門真	大阪府門真市
セッツ	摂津	大阪府摂津市
タカイシ	高石	大阪府高石市
フジイデラ	藤井寺	大阪府藤井寺市
ヒガシオオサカ	東大阪	大阪府東大阪市
センナン	泉南	大阪府泉南市
シジヨウナワテ	四條畷	大阪府四條畷市
カタノ	交野	大阪府交野市
オオサカサヤマ	大阪狭山	大阪府大阪狭山市
ハンナン	阪南	大阪府阪南市
シマモト	島本	大阪府島本町
トヨノ	豊能	大阪府豊能町
ノセ	能勢	大阪府能勢町
タダオカ	忠岡	大阪府忠岡町
クマトリ	熊取	大阪府熊取町
タジリ	田尻	大阪府田尻町
ミサキ	岬	大阪府岬町
タイシ	太子	大阪府太子町
カナン	河南	大阪府河南町
チハヤアカサカ	千早赤阪	大阪府千早赤阪村
コウベ	神戸	兵庫県神戸市
ヒメジ	姫路	兵庫県姫路市
アマガサキ	尼崎	兵庫県尼崎市
アカシ	明石	兵庫県明石市
ニシノミヤ	西宮	兵庫県西宮市
スモト	洲本	兵庫県洲本市
アシヤ	芦屋	兵庫県芦屋市
イタミ	伊丹	兵庫県伊丹市
アイオイ	相生	兵庫県相生市
トヨオカ	豊岡	兵庫県豊岡市
カコガワ	加古川	兵庫県加古川市
アコウ	赤穂	兵庫県赤穂市
ニシワキ	西脇	兵庫県西脇市
タカラヅカ	宝塚	兵庫県宝塚市
ミキ	三木	兵庫県三木市
タカサゴ	高砂	兵庫県高砂市
カワニシ	川西	兵庫県川西市
オノ	小野	兵庫県小野市
サンダ	三田	兵庫県三田市
カサイ	加西	兵庫県加西市
ササヤマ	篠山	兵庫県篠山市
ヤブ	養父	兵庫県養父市
タンバ	丹波	兵庫県丹波市
ミナミアワジ	南あわじ	兵庫県南あわじ市
アサゴ	朝来	兵庫県朝来市
アワジ	淡路	兵庫県淡路市
シソウ	宍粟	兵庫県宍粟市
カトウ	加東	兵庫県加東市
タツノ	たつの	兵庫県たつの市
イナガワ	猪名川	兵庫県猪名川町
タカ	多可	兵庫県多可町
イナミ	稲美	兵庫県稲美町
ハリマ	播磨	兵庫県播磨町
イチカワ	市川	兵庫県市川町
フクサキ	福崎	兵庫県福崎町
カミカワ	神河	兵庫県神河町
タイシ	太子	兵庫県太子町
カミゴオリ	上郡	兵庫県上郡町
サヨウ	佐用	兵庫県佐用町
カミ	香美	兵庫県香美町
シンオンセン	新温泉	兵庫県新温泉町
ナラ	奈良	奈良県奈良市
ヤマトタカダ	大和高田	奈良県大和高田市
ヤマトコオリヤマ	大和郡山	奈良県大和郡山市
テンリ	天理	奈良県天理市
カシハラ	橿原	奈良県橿原市
サクライ	桜井	奈良県桜井市
ゴジョウ	五條	奈良県五條市
ゴセ	御所	奈良県御所市
イコマ	生駒	奈良県生駒市
カシバ	香芝	奈良県香芝市
カツラギ	葛城	奈良県葛城市
ウダ	宇陀	奈良県宇陀市
ヤマゾエ	山添	奈良県山添村
ヘグリ	平群	奈良県平群町
サンゴウ	三郷	奈良県三郷町
イカルガ	斑鳩	奈良県斑鳩町
アンド	安堵	奈良県安堵町
カワニシ	川西	奈良県川西町
ミヤケ	三宅	奈良県三宅町
タワラモト	田原本	奈良県田原本町
ソニ	曽爾	奈良県曽爾村
ミツエ	御杖	奈良県御杖村
タカトリ	高取	奈良県高取町
アスカ	明日香	奈良県明日香村
カンマキ	上牧	奈良県上牧町
オウジ	王寺	奈良県王寺町
コウリヨウ	広陵	奈良県広陵町
カワイ	河合	奈良県河合町
ヨシノ	吉野	奈良県吉野町
オオヨド	大淀	奈良県大淀町
シモイチ	下市	奈良県下市町
クロタキ	黒滝	奈良県黒滝村
テンカワ	天川	奈良県天川村
ノセガワ	野迫川	奈良県野迫川村
トツカワ	十津川	奈良県十津川村
シモキタヤマ	下北山	奈良県下北山村
カミキタヤマ	上北山	奈良県上北山村
カワカミ	川上	奈良県川上村
ヒガシヨシノ	東吉野	奈良県東吉野村
ワカヤマ	和歌山	和歌山県和歌山市
カイナン	海南	和歌山県海南市
ハシモト	橋本	和歌山県橋本市
アリダ	有田	和歌山県有田市
ゴボウ	御坊	和歌山県御坊市
タナベ	田辺	和歌山県田辺市
シングウ	新宮	和歌山県新宮市
キノカワ	紀の川	和歌山県紀の川市
イワデ	岩出	和歌山県岩出市
キミノ	紀美野	和歌山県紀美野町
カツラギ	かつらぎ	和歌山県かつらぎ町
クドヤマ	九度山	和歌山県九度山町
コウヤ	高野	和歌山県高野町
ユアサ	湯浅	和歌山県湯浅町
ヒロガワ	広川	和歌山県広川町
アリダガワ	有田川	和歌山県有田川町
ミハマ	美浜	和歌山県美浜町
ヒダカ	日高	和歌山県日高町
ユラ	由良	和歌山県由良町
イナミ	印南	和歌山県印南町
ミナベ	みなべ	和歌山県みなべ町
ヒダカガワ	日高川	和歌山県日高川町
シラハマ	白浜	和歌山県白浜町
カミトンダ	上富田	和歌山県上富田町
スサミ	すさみ	和歌山県すさみ町
ナチカツウラ	那智勝浦	和歌山県那智勝浦町
タイジ	太地	和歌山県太地町
コザガワ	古座川	和歌山県古座川町
キタヤマ	北山	和歌山県北山村
クシモト	串本	和歌山県串本町
トットリ	鳥取	鳥取県鳥取市
ヨナゴ	米子	鳥取県米子市
クラヨシ	倉吉	鳥取県倉吉市
サカイミナト	境港	鳥取県境港市
イワミ	岩美	鳥取県岩美町
ワカサ	若桜	鳥取県若桜町
チヅ	智頭	鳥取県智頭町
ヤズ	八頭	鳥取県八頭町
ミササ	三朝	鳥取県三朝町
ユリハマ	湯梨浜	鳥取県湯梨浜町
コトウラ	琴浦	鳥取県琴浦町
ホクエイ	北栄	鳥取県北栄町
ヒエヅ	日吉津	鳥取県日吉津村
ダイセン	大山	鳥取県大山町
ナンブ	南部	鳥取県南部町
ホウキ	伯耆	鳥取県伯耆町
ニチナン	日南	鳥取県日南町
ヒノ	日野	鳥取県日野町
コウフ	江府	鳥取県江府町
マツエ	松江	島根県松江市
ハマダ	浜田	島根県浜田市
イズモ	出雲	島根県出雲市
マスダ	益田	島根県益田市
オオダ	大田	島根県大田市
ヤスギ	安来	島根県安来市
ゴウツ	江津	島根県江津市
ウンナン	雲南	島根県雲南市
オクイズモ	奥出雲	島根県奥出雲町
イイナン	飯南	島根県飯南町
カワモト	川本	島根県川本町
ミサト	美郷	島根県美郷町
オオナン	邑南	島根県邑南町
ツワノ	津和野	島根県津和野町
ヨシカ	吉賀	島根県吉賀町
アマ	海士	島根県海士町
ニシノシマ	西ノ島	島根県西ノ島町
チブ	知夫	島根県知夫村
オキノシマ	隠岐の島	島根県隠岐の島町
オカヤマ	岡山	岡山県岡山市
クラシキ	倉敷	岡山県倉敷市
ツヤマ	津山	岡山県津山市
タマノ	玉野	岡山県玉野市
カサオカ	笠岡	岡山県笠岡市
イバラ	井原	岡山県井原市
ソウジヤ	総社	岡山県総社市
タカハシ	高梁	岡山県高梁市
ニイミ	新見	岡山県新見市
ビゼン	備前	岡山県備前市
セトウチ	瀬戸内	岡山県瀬戸内市
アカイワ	赤磐	岡山県赤磐市
マニワ	真庭	岡山県真庭市
ミマサカ	美作	岡山県美作市
アサクチ	浅口	岡山県浅口市
ワケ	和気	岡山県和気町
ハヤシマ	早島	岡山県早島町
サトショウ	里庄	岡山県里庄町
ヤカゲ	矢掛	岡山県矢掛町
シンジヨウ	新庄	岡山県新庄村
カガミノ	鏡野	岡山県鏡野町
ショウオウ	勝央	岡山県勝央町
ナギ	奈義	岡山県奈義町
ニシアワクラ	西粟倉	岡山県西粟倉村
クメナン	久米南	岡山県久米南町
ミサキ	美咲	岡山県美咲町
キビチュウオウ	吉備中央	岡山県吉備中央町
ヒロシマ	広島	広島県広島市
クレ	呉	広島県呉市
タケハラ	竹原	広島県竹原市
ミハラ	三原	広島県三原市
オノミチ	尾道	広島県尾道市
フクヤマ	福山	広島県福山市
フチュウ	府中	広島県府中市
ミヨシ	三次	広島県三次市
ショウバラ	庄原	広島県庄原市
オオタケ	大竹	広島県大竹市
ヒガシヒロシマ	東広島	広島県東広島市
ハツカイチ	廿日市	広島県廿日市市
アキタカタ	安芸高田	広島県安芸高田市
エタジマ	江田島	広島県江田島市
フチュウ	府中	広島県府中町
カイタ	海田	広島県海田町
クマノ	熊野	広島県熊野町
サカ	坂	広島県坂町
アキオオタ	安芸太田	広島県安芸太田町
キタヒロシマ	北広島	広島県北広島町
オオサキカミジマ	大崎上島	広島県大崎上島町
セラ	世羅	広島県世羅町
ジンセキコウゲン	神石高原	広島県神石高原町
シモノセキ	下関	山口県下関市
ウベ	宇部	山口県宇部市
ヤマグチ	山口	山口県山口市
ハギ	萩	山口県萩市
ホウフ	防府	山口県防府市
クダマツ	下松	山口県下松市
イワクニ	岩国	山口県岩国市
ヒカリ	光	山口県光市
ナガト	長門	山口県長門市
ヤナイ	柳井	山口県柳井市
ミネ	美祢	山口県美祢市
シュウナン	周南	山口県周南市
サンヨウオノダ	山陽小野田	山口県山陽小野田市
スオウオオシマ	周防大島	山口県周防大島町
ワキ	和木	山口県和木町
カミノセキ	上関	山口県上関町
タブセ	田布施	山口県田布施町
ヒラオ	平生	山口県平生町
アブ	阿武	山口県阿武町
トクシマ	徳島	徳島県徳島市
ナルト	鳴門	徳島県鳴門市
コマツシマ	小松島	徳島県小松島市
アナン	阿南	徳島県阿南市
ヨシノガワ	吉野川	徳島県吉野川市
アワ	阿波	徳島県阿波市
ミマ	美馬	徳島県美馬市
ミヨシ	三好	徳島県三好市
カツウラ	勝浦	徳島県勝浦町
カミカツ	上勝	徳島県上勝町
サナゴウチ	佐那河内	徳島県佐那河内村
イシイ	石井	徳島県石井町
カミヤマ	神山	徳島県神山町
ナカ	那賀	徳島県那賀町
ムギ	牟岐	徳島県牟岐町
ミナミ	美波	徳島県美波町
カイヨウ	海陽	徳島県海陽町
マツシゲ	松茂	徳島県松茂町
キタジマ	北島	徳島県北島町
アイズミ	藍住	徳島県藍住町
イタノ	板野	徳島県板野町
カミイタ	上板	徳島県上板町
ツルギ	つるぎ	徳島県つるぎ町
ヒガシミヨシ	東みよし	徳島県東みよし町
タカマツ	高松	香川県高松市
マルガメ	丸亀	香川県丸亀市
サカイデ	坂出	香川県坂出市
ゼンツウジ	善通寺	香川県善通寺市
カンオンジ	観音寺	香川県観音寺市
サヌキ	さぬき	香川県さぬき市
ヒガシカガワ	東かがわ	香川県東かがわ市
ミトヨ	三豊	香川県三豊市
トノショウ	土庄	香川県土庄町
ショウドシマ	小豆島	香川県小豆島町
ミキ	三木	香川県三木町
ナオシマ	直島	香川県直島町
ウタヅ	宇多津	香川県宇多津町
アヤガワ	綾川	香川県綾川町
コトヒラ	琴平	香川県琴平町
タドツ	多度津	香川県多度津町
マンノウ	まんのう	香川県まんのう町
マツヤマ	松山	愛媛県松山市
イマバリ	今治	愛媛県今治市
ウワジマ	宇和島	愛媛県宇和島市
ヤワタハマ	八幡浜	愛媛県八幡浜市
ニイハマ	新居浜	愛媛県新居浜市
サイジョウ	西条	愛媛県西条市
オオズ	大洲	愛媛県大洲市
イヨ	伊予	愛媛県伊予市
シコクチュウオウ	四国中央	愛媛県四国中央市
セイヨ	西予	愛媛県西予市
トウオン	東温	愛媛県東温市
カミジマ	上島	愛媛県上島町
クマコウゲン	久万高原	愛媛県久万高原町
マサキ	松前	愛媛県松前町
トベ	砥部	愛媛県砥部町
ウチコ	内子	愛媛県内子町
イカタ	伊方	愛媛県伊方町
マツノ	松野	愛媛県松野町
キホク	鬼北	愛媛県鬼北町
アイナン	愛南	愛媛県愛南町
コウチ	高知	高知県高知市
ムロト	室戸	高知県室戸市
アキ	安芸	高知県安芸市
ナンコク	南国	高知県南国市
トサ	土佐	高知県土佐市
スサキ	須崎	高知県須崎市
スクモ	宿毛	高知県宿毛市
トサシミズ	土佐清水	高知県土佐清水市
シマント	四万十	高知県四万十市
コウナン	香南	高知県香南市
カミ	香美	高知県香美市
トウヨウ	東洋	高知県東洋町
ナハリ	奈半利	高知県奈半利町
タノ	田野	高知県田野町
ヤスダ	安田	高知県安田町
キタガワ	北川	高知県北川村
ウマジ	馬路	高知県馬路村
ゲイセイ	芸西	高知県芸西村
モトヤマ	本山	高知県本山町
オオトヨ	大豊	高知県大豊町
トサ	土佐	高知県土佐町
オオカワ	大川	高知県大川村
イノ	いの	高知県いの町
ニヨドガワ	仁淀川	高知県仁淀川町
ナカトサ	中土佐	高知県中土佐町
サカワ	佐川	高知県佐川町
オチ	越知	高知県越知町
ユスハラ	梼原	高知県梼原町
ヒダカ	日高	高知県日高村
ツノ	津野	高知県津野町
シマント	四万十	高知県四万十町
オオツキ	大月	高知県大月町
ミハラ	三原	高知県三原村
クロシオ	黒潮	高知県黒潮町
キタキュウシュウ	北九州	福岡県北九州市
フクオカ	福岡	福岡県福岡市
オオムタ	大牟田	福岡県大牟田市
クルメ	久留米	福岡県久留米市
ノオガタ	直方	福岡県直方市
イイヅカ	飯塚	福岡県飯塚市
タガワ	田川	福岡県田川市
ヤナガワ	柳川	福岡県柳川市
ヤメ	八女	福岡県八女市
チクゴ	筑後	福岡県筑後市
オオカワ	大川	福岡県大川市
ユクハシ	行橋	福岡県行橋市
ブゼン	豊前	福岡県豊前市
ナカマ	中間	福岡県中間市
オゴオリ	小郡	福岡県小郡市
チクシノ	筑紫野	福岡県筑紫野市
カスガ	春日	福岡県春日市
オオノジョウ	大野城	福岡県大野城市
ムナカタ	宗像	福岡県宗像市
ダザイフ	太宰府	福岡県太宰府市
コガ	古賀	福岡県古賀市
フクツ	福津	福岡県福津市
ウキハ	うきは	福岡県うきは市
ミヤワカ	宮若	福岡県宮若市
カマ	嘉麻	福岡県嘉麻市
アサクラ	朝倉	福岡県朝倉市
ミヤマ	みやま	福岡県みやま市
イトシマ	糸島	福岡県糸島市
ナカガワ	那珂川	福岡県那珂川市
ウミ	宇美	福岡県宇美町
ササグリ	篠栗	福岡県篠栗町
シメ	志免	福岡県志免町
スエ	須恵	福岡県須恵町
シングウ	新宮	福岡県新宮町
ヒサヤマ	久山	福岡県久山町
カスヤ	粕屋	福岡県粕屋町
アシヤ	芦屋	福岡県芦屋町
ミズマキ	水巻	福岡県水巻町
オカガキ	岡垣	福岡県岡垣町
オンガ	遠賀	福岡県遠賀町
コタケ	小竹	福岡県小竹町
クラテ	鞍手	福岡県鞍手町
ケイセン	桂川	福岡県桂川町
チクゼン	筑前	福岡県筑前町
トウホウ	東峰	福岡県東峰村
タチアライ	大刀洗	福岡県大刀洗町
オオキ	大木	福岡県大木町
ヒロカワ	広川	福岡県広川町
カワラ	香春	福岡県香春町
ソエダ	添田	福岡県添田町
イトダ	糸田	福岡県糸田町
カワサキ	川崎	福岡県川崎町
オオトウ	大任	福岡県大任町
アカ	赤	福岡県赤村
フクチ	福智	福岡県福智町
カンダ	苅田	福岡県苅田町
ミヤコ	みやこ	福岡県みやこ町
ヨシトミ	吉富	福岡県吉富町
コウゲ	上毛	福岡県上毛町
チクジョウ	築上	福岡県築上町
サガ	佐賀	佐賀県佐賀市
カラツ	唐津	佐賀県唐津市
トス	鳥栖	佐賀県鳥栖市
タク	多久	佐賀県多久市
イマリ	伊万里	佐賀県伊万里市
タケオ	武雄	佐賀県武雄市
カシマ	鹿島	佐賀県鹿島市
オギ	小城	佐賀県小城市
ウレシノ	嬉野	佐賀県嬉野市
カンザキ	神埼	佐賀県神埼市
ヨシノガリ	吉野ヶ里	佐賀県吉野ヶ里町
キヤマ	基山	佐賀県基山町
カミミネ	上峰	佐賀県上峰町
ミヤキ	みやき	佐賀県みやき町
ゲンカイ	玄海	佐賀県玄海町
アリタ	有田	佐賀県有田町
オオマチ	大町	佐賀県大町町
コウホク	江北	佐賀県江北町
シロイシ	白石	佐賀県白石町
タラ	太良	佐賀県太良町
ナガサキ	長崎	長崎県長崎市
サセボ	佐世保	長崎県佐世保市
シマバラ	島原	長崎県島原市
イサハヤ	諫早	長崎県諫早市
オオムラ	大村	長崎県大村市
ヒラド	平戸	長崎県平戸市
マツウラ	松浦	長崎県松浦市
ツシマ	対馬	長崎県対馬市
イキ	壱岐	長崎県壱岐市
ゴトウ	五島	長崎県五島市
サイカイ	西海	長崎県西海市
ウンゼン	雲仙	長崎県雲仙市
ミナミシマバラ	南島原	長崎県南島原市
ナガヨ	長与	長崎県長与町
トギツ	時津	長崎県時津町
ヒガシソノギ	東彼杵	長崎県東彼杵町
カワタナ	川棚	長崎県川棚町
ハサミ	波佐見	長崎県波佐見町
オヂカ	小値賀	長崎県小値賀町
サザ	佐々	長崎県佐々町
シンカミゴトウ	新上五島	長崎県新上五島町
クマモト	熊本	熊本県熊本市
ヤツシロ	八代	熊本県八代市
ヒトヨシ	人吉	熊本県人吉市
アラオ	荒尾	熊本県荒尾市
ミナマタ	水俣	熊本県水俣市
タマナ	玉名	熊本県玉名市
ヤマガ	山鹿	熊本県山鹿市
キクチ	菊池	熊本県菊池市
ウト	宇土	熊本県宇土市
カミアマクサ	上天草	熊本県上天草市
ウキ	宇城	熊本県宇城市
アソ	阿蘇	熊本県阿蘇市
アマクサ	天草	熊本県天草市
コウシ	合志	熊本県合志市
ミサト	美里	熊本県美里町
ギョクトウ	玉東	熊本県玉東町
ナンカン	南関	熊本県南関町
ナガス	長洲	熊本県長洲町
ナゴミ	和水	熊本県和水町
オオヅ	大津	熊本県大津町
キクヨウ	菊陽	熊本県菊陽町
ミナミオグニ	南小国	熊本県南小国町
オグニ	小国	熊本県小国町
ウブヤマ	産山	熊本県産山村
タカモリ	高森	熊本県高森町
ニシハラ	西原	熊本県西原村
ミナミアソ	南阿蘇	熊本県南阿蘇村
ミフネ	御船	熊本県御船町
カシマ	嘉島	熊本県嘉島町
マシキ	益城	熊本県益城町
コウサ	甲佐	熊本県甲佐町
ヤマト	山都	熊本県山都町
ヒカワ	氷川	熊本県氷川町
アシキタ	芦北	熊本県芦北町
ツナギ	津奈木	熊本県津奈木町
ニシキ	錦	熊本県錦町
タラギ	多良木	熊本県多良木町
ユノマエ	湯前	熊本県湯前町
ミズカミ	水上	熊本県水上村
サガラ	相良	熊本県相良村
イツキ	五木	熊本県五木村
ヤマエ	山江	熊本県山江村
クマ	球磨	熊本県球磨村
アサギリ	あさぎり	熊本県あさぎり町
レイホク	苓北	熊本県苓北町
オオイタ	大分	大分県大分市
ベップ	別府	大分県別府市
ナカツ	中津	大分県中津市
ヒタ	日田	大分県日田市
サイキ	佐伯	大分県佐伯市
ウスキ	臼杵	大分県臼杵市
ツクミ	津久見	大分県津久見市
タケタ	竹田	大分県竹田市
ブンゴタカダ	豊後高田	大分県豊後高田市
キツキ	杵築	大分県杵築市
ウサ	宇佐	大分県宇佐市
ブンゴオオノ	豊後大野	大分県豊後大野市
ユフ	由布	大分県由布市
クニサキ	国東	大分県国東市
ヒメシマ	姫島	大分県姫島村
ヒジ	日出	大分県日出町
ココノエ	九重	大分県九重町
クス	玖珠	大分県玖珠町
ミヤザキ	宮崎	宮崎県宮崎市
ミヤコノジョウ	都城	宮崎県都城市
ノベオカ	延岡	宮崎県延岡市
ニチナン	日南	宮崎県日南市
コバヤシ	小林	宮崎県小林市
ヒュウガ	日向	宮崎県日向市
クシマ	串間	宮崎県串間市
サイト	西都	宮崎県西都市
エビノ	えびの	宮崎県えびの市
ミマタ	三股	宮崎県三股町
タカハル	高原	宮崎県高原町
クニトミ	国富	宮崎県国富町
アヤ	綾	宮崎県綾町
タカナベ	高鍋	宮崎県高鍋町
シントミ	新富	宮崎県新富町
ニシメラ	西米良	宮崎県西米良村
キジョウ	木城	宮崎県木城町
カワミナミ	川南	宮崎県川南町
ツノ	都農	宮崎県都農町
カドガワ	門川	宮崎県門川町
モロツカ	諸塚	宮崎県諸塚村
シイバ	椎葉	宮崎県椎葉村
ミサト	美郷	宮崎県美郷町
タカチホ	高千穂	宮崎県高千穂町
ヒノカゲ	日之影	宮崎県日之影町
ゴカセ	五ヶ瀬	宮崎県五ヶ瀬町
カゴシマ	鹿児島	鹿児島県鹿児島市
カノヤ	鹿屋	鹿児島県鹿屋市
マクラザキ	枕崎	鹿児島県枕崎市
アクネ	阿久根	鹿児島県阿久根市
イズミ	出水	鹿児島県出水市
イブスキ	指宿	鹿児島県指宿市
ニシノオモテ	西之表	鹿児島県西之表市
タルミズ	垂水	鹿児島県垂水市
サツマセンダイ	薩摩川内	鹿児島県薩摩川内市
ヒオキ	日置	鹿児島県日置市
ソオ	曽於	鹿児島県曽於市
キリシマ	霧島	鹿児島県霧島市
イチキクシキノ	いちき串木野	鹿児島県いちき串木野市
ミナミサツマ	南さつま	鹿児島県南さつま市
シブシ	志布志	鹿児島県志布志市
アマミ	奄美	鹿児島県奄美市
ミナミキュウシュウ	南九州	鹿児島県南九州市
イサ	伊佐	鹿児島県伊佐市
アイラ	姶良	鹿児島県姶良市
ミシマ	三島	鹿児島県三島村
トシマ	十島	鹿児島県十島村
サツマ	さつま	鹿児島県さつま町
ナガシマ	長島	鹿児島県長島町
ユウスイ	湧水	鹿児島県湧水町
オオサキ	大崎	鹿児島県大崎町
ヒガシクシラ	東串良	鹿児島県東串良町
キンコウ	錦江	鹿児島県錦江町
ミナミオオスミ	南大隅	鹿児島県南大隅町
キモツキ	肝付	鹿児島県肝付町
ナカタネ	中種子	鹿児島県中種子町
ミナミタネ	南種子	鹿児島県南種子町
ヤクシマ	屋久島	鹿児島県屋久島町
ヤマト	大和	鹿児島県大和村
ウケン	宇検	鹿児島県宇検村
セトウチ	瀬戸内	鹿児島県瀬戸内町
タツゴウ	龍郷	鹿児島県龍郷町
キカイ	喜界	鹿児島県喜界町
トクノシマ	徳之島	鹿児島県徳之島町
アマギ	天城	鹿児島県天城町
イセン	伊仙	鹿児島県伊仙町
ワドマリ	和泊	鹿児島県和泊町
チナ	知名	鹿児島県知名町
ヨロン	与論	鹿児島県与論町
ナハ	那覇	沖縄県那覇市
ギノワン	宜野湾	沖縄県宜野湾市
イシガキ	石垣	沖縄県石垣市
ウラソエ	浦添	沖縄県浦添市
ナゴ	名護	沖縄県名護市
イトマン	糸満	沖縄県糸満市
オキナワ	沖縄	沖縄県沖縄市
トミグスク	豊見城	沖縄県豊見城市
ウルマ	うるま	沖縄県うるま市
ミヤコジマ	宮古島	沖縄県宮古島市
ナンジョウ	南城	沖縄県南城市
クニガミ	国頭	沖縄県国頭村
オオギミ	大宜味	沖縄県大宜味村
ヒガシ	東	沖縄県東村
ナキジン	今帰仁	沖縄県今帰仁村
モトブ	本部	沖縄県本部町
オンナ	恩納	沖縄県恩納村
ギノザ	宜野座	沖縄県宜野座村
キン	金武	沖縄県金武町
イエ	伊江	沖縄県伊江村
ヨミタン	読谷	沖縄県読谷村
カデナ	嘉手納	沖縄県嘉手納町
チヤタン	北谷	沖縄県北谷町
キタナカグスク	北中城	沖縄県北中城村
ナカグスク	中城	沖縄県中城村
ニシハラ	西原	沖縄県西原町
ヨナバル	与那原	沖縄県与那原町
ハエバル	南風原	沖縄県南風原町
トカシキ	渡嘉敷	沖縄県渡嘉敷村
ザマミ	座間味	沖縄県座間味村
アグニ	粟国	沖縄県粟国村
トナキ	渡名喜	沖縄県渡名喜村
ミナミダイトウ	南大東	沖縄県南大東村
キタダイトウ	北大東	沖縄県北大東村
イヘヤ	伊平屋	沖縄県伊平屋村
イゼナ	伊是名	沖縄県伊是名村
クメジマ	久米島	沖縄県久米島町
ヤエセ	八重瀬	沖縄県八重瀬町
タラマ	多良間	沖縄県多良間村
タケトミ	竹富	沖縄県竹富町
ヨナグニ	与那国	沖縄県与那国町
チュウオウ	中央	北海道札幌市中央区
キタ	北	北海道札幌市北区
ヒガシ	東	北海道札幌市東区
シロイシ	白石	北海道札幌市白石区
トヨヒラ	豊平	北海道札幌市豊平区
ミナミ	南	北海道札幌市南区
ニシ	西	北海道札幌市西区
アツベツ	厚別	北海道札幌市厚別区
テイネ	手稲	北海道札幌市手稲区
キヨタ	清田	北海道札幌市清田区
アオバ	青葉	宮城県仙台市青葉区
ミヤギノ	宮城野	宮城県仙台市宮城野区
ワカバヤシ	若林	宮城県仙台市若林区
タイハク	太白	宮城県仙台市太白区
イズミ	泉	宮城県仙台市泉区
ニシ	西	埼玉県さいたま市西区
キタ	北	埼玉県さいたま市北区
オオミヤ	大宮	埼玉県さいたま市大宮区
ミヌマ	見沼	埼玉県さいたま市見沼区
チュウオウ	中央	埼玉県さいたま市中央区
サクラ	桜	埼玉県さいたま市桜区
ウラワ	浦和	埼玉県さいたま市浦和区
ミナミ	南	埼玉県さいたま市南区
ミドリ	緑	埼玉県さいたま市緑区
イワツキ	岩槻	埼玉県さいたま市岩槻区
チュウオウ	中央	千葉県千葉市中央区
ハナミガワ	花見川	千葉県千葉市花見川区
イナゲ	稲毛	千葉県千葉市稲毛区
ワカバ	若葉	千葉県千葉市若葉区
ミドリ	緑	千葉県千葉市緑区
ミハマ	美浜	千葉県千葉市美浜区
ツルミ	鶴見	神奈川県横浜市鶴見区
カナガワ	神奈川	神奈川県横浜市神奈川区
ニシ	西	神奈川県横浜市西区
ナカ	中	神奈川県横浜市中区
ミナミ	南	神奈川県横浜市南区
ホドガヤ	保土ケ谷	神奈川県横浜市保土ケ谷区
イソゴ	磯子	神奈川県横浜市磯子区
カナザワ	金沢	神奈川県横浜市金沢区
コウホク	港北	神奈川県横浜市港北区
トツカ	戸塚	神奈川県横浜市戸塚区
コウナン	港南	神奈川県横浜市港南区
アサヒ	旭	神奈川県横浜市旭区
ミドリ	緑	神奈川県横浜市緑区
セヤ	瀬谷	神奈川県横浜市瀬谷区
サカエ	栄	神奈川県横浜市栄区
イズミ	泉	神奈川県横浜市泉区
アオバ	青葉	神奈川県横浜市青葉区
ツヅキ	都筑	神奈川県横浜市都筑区
カワサキ	川崎	神奈川県川崎市川崎区
サイワイ	幸	神奈川県川崎市幸区
ナカハラ	中原	神奈川県川崎市中原区
タカツ	高津	神奈川県川崎市高津区
タマ	多摩	神奈川県川崎市多摩区
ミヤマエ	宮前	神奈川県川崎市宮前区
アサオ	麻生	神奈川県川崎市麻生区
ミドリ	緑	神奈川県相模原市緑区
チュウオウ	中央	神奈川県相模原市中央区
ミナミ	南	神奈川県相模原市南区
キタ	北	新潟県新潟市北区
ヒガシ	東	新潟県新潟市東区
チュウオウ	中央	新潟県新潟市中央区
コウナン	江南	新潟県新潟市江南区
アキハ	秋葉	新潟県新潟市秋葉区
ミナミ	南	新潟県新潟市南区
ニシ	西	新潟県新潟市西区
ニシカン	西蒲	新潟県新潟市西蒲区
アオイ	葵	静岡県静岡市葵区
スルガ	駿河	静岡県静岡市駿河区
シミズ	清水	静岡県静岡市清水区
ナカ	中	静岡県浜松市中区
ヒガシ	東	静岡県浜松市東区
ニシ	西	静岡県浜松市西区
ミナミ	南	静岡県浜松市南区
キタ	北	静岡県浜松市北区
ハマキタ	浜北	静岡県浜松市浜北区
テンリュウ	天竜	静岡県浜松市天竜区
チクサ	千種	愛知県名古屋市千種区
ヒガシ	東	愛知県名古屋市東区
キタ	北	愛知県名古屋市北区
ニシ	西	愛知県名古屋市西区
ナカムラ	中村	愛知県名古屋市中村区
ナカ	中	愛知県名古屋市中区
ショウワ	昭和	愛知県名古屋市昭和区
ミズホ	瑞穂	愛知県名古屋市瑞穂区
アツタ	熱田	愛知県名古屋市熱田区
ナカガワ	中川	愛知県名古屋市中川区
ミナト	港	愛知県名古屋市港区
ミナミ	南	愛知県名古屋市南区
モリヤマ	守山	愛知県名古屋市守山区
ミドリ	緑	愛知県名古屋市緑区
メイトウ	名東	愛知県名古屋市名東区
テンパク	天白	愛知県名古屋市天白区
キタ	北	京都府京都市北区
カミギョウ	上京	京都府京都市上京区
サキョウ	左京	京都府京都市左京区
ナカギョウ	中京	京都府京都市中京区
ヒガシヤマ	東山	京都府京都市東山区
シモギョウ	下京	京都府京都市下京区
ミナミ	南	京都府京都市南区
ウキョウ	右京	京都府京都市右京区
フシミ	伏見	京都府京都市伏見区
ヤマシナ	山科	京都府京都市山科区
ニシキョウ	西京	京都府京都市西京区
ミヤコジマ	都島	大阪府大阪市都島区
フクシマ	福島	大阪府大阪市福島区
コノハナ	此花	大阪府大阪市此花区
ニシ	西	大阪府大阪市西区
ミナト	港	大阪府大阪市港区
タイショウ	大正	大阪府大阪市大正区
テンノウジ	天王寺	大阪府大阪市天王寺区
ナニワ	浪速	大阪府大阪市浪速区
ニシヨドガワ	西淀川	大阪府大阪市西淀川区
ヒガシヨドガワ	東淀川	大阪府大阪市東淀川区
ヒガシナリ	東成	大阪府大阪市東成区
イクノ	生野	大阪府大阪市生野区
アサヒ	旭	大阪府大阪市旭区
ジョウトウ	城東	大阪府大阪市城東区
アベノ	阿倍野	大阪府大阪市阿倍野区
スミヨシ	住吉	大阪府大阪市住吉区
ヒガシスミヨシ	東住吉	大阪府大阪市東住吉区
ニシナリ	西成	大阪府大阪市西成区
ヨドガワ	淀川	大阪府大阪市淀川区
ツルミ	鶴見	大阪府大阪市鶴見区
スミノエ	住之江	大阪府大阪市住之江区
ヒラノ	平野	大阪府大阪市平野区
キタ	北	大阪府大阪市北区
チュウオウ	中央	大阪府大阪市中央区
サカイ	堺	大阪府堺市堺区
ナカ	中	大阪府堺市中区
ヒガシ	東	大阪府堺市東区
ニシ	西	大阪府堺市西区
ミナミ	南	大阪府堺市南区
キタ	北	大阪府堺市北区
ミハラ	美原	大阪府堺市美原区
ヒガシナダ	東灘	兵庫県神戸市東灘区
ナダ	灘	兵庫県神戸市灘区
ヒョウゴ	兵庫	兵庫県神戸市兵庫区
ナガタ	長田	兵庫県神戸市長田区
スマ	須磨	兵庫県神戸市須磨区
タルミ	垂水	兵庫県神戸市垂水区
キタ	北	兵庫県神戸市北区
チュウオウ	中央	兵庫県神戸市中央区
ニシ	西	兵庫県神戸市西区
キタ	北	岡山県岡山市北区
ナカ	中	岡山県岡山市中区
ヒガシ	東	岡山県岡山市東区
ミナミ	南	岡山県岡山市南区
ナカ	中	広島県広島市中区
ヒガシ	東	広島県広島市東区
ミナミ	南	広島県広島市南区
ニシ	西	広島県広島市西区
アサミナミ	安佐南	広島県広島市安佐南区
アサキタ	安佐北	広島県広島市安佐北区
アキ	安芸	広島県広島市安芸区
サエキ	佐伯	広島県広島市佐伯区
モジ	門司	福岡県北九州市門司区
ワカマツ	若松	福岡県北九州市若松区
トバタ	戸畑	福岡県北九州市戸畑区
コクラキタ	小倉北	福岡県北九州市小倉北区
コクラミナミ	小倉南	福岡県北九州市小倉南区
ヤハタヒガシ	八幡東	福岡県北九州市八幡東区
ヤハタニシ	八幡西	福岡県北九州市八幡西区
ヒガシ	東	福岡県福岡市東区
ハカタ	博多	福岡県福岡市博多区
チュウオウ	中央	福岡県福岡市中央区
ミナミ	南	福岡県福岡市南区
ニシ	西	福岡県福岡市西区
ジョウナン	城南	福岡県福岡市城南区
サワラ	早良	福岡県福岡市早良区
チュウオウ	中央	熊本県熊本市中央区
ヒガシ	東	熊本県熊本市東区
ニシ	西	熊本県熊本市西区
ミナミ	南	熊本県熊本市南区
キタ	北	熊本県熊本市北区
